1111111111111111111111111111
1P100010001000C00000000000E1
10101010101000000C0011111111
101010101010C000000000000011
100010001000000C000000000001

1111111111111111111111111111