1111111111111111111111111111
1P100010001000C00N00000000E1
10101010101000000C0011111111
101010101010C0000000000N0011
100010001000000C0000000000C1
1111111111111111111111111111