11111111111111
1P110000011111
10110110011111
10110111111111
10000111111111
11111111111111