1111111111111111111111111111111111111111
111100N00001111111111111111110000C001111
1111000010001111111111111111001100001111
1111N0001100011111111111111000110C001111
111100C011100C1111111111110C011100N01111
1111000011110C01111111111C00111100C01111
11110N0011111000111111110001111100001111
111100001111110C01111110C011111100001111
1111000011111110N0111100011111110C001111
1111000011111111000110C01111111100001111
111100001111111110C000011111111100001111
11110000111111111100N01111111111000C1111
11110C001111111111100111111111110C001111
11110N0011111111111001111111111100001111
11110000111C0C0C0C0C0C0C00C1111100C01111
11110000111CC0C0C0C0C0C0C0C111110N001111
11110000111C00000000000000C1111100001111
11110111111C00000000000000C1111111101111
1P000111111CCCCCCCCCCCCCCCCC1111111000E1
1111111111111111111111111111111111111111