11111111111111111111111111
11111111111111111111111111
10000P00000C00000110000001
10001111111C01110100000001
10000000000000C000001E10C1
11111111111111111111111111