1111111111111111
11111PCE11111111
1111111111111111